1111111111
11000000P1
1111111111
