1111111111
111PCE11111
1111111111
