1111111111
1100000001
11PCEA0001
1111111111
