1111111111
11PCE11110
1111111111
